Вперёд!	F1
Отступаем!	F2
Огонь на подавление!	F3
Атаковать с левого фланга!	F4
Атаковать по центру!	F5
Атаковать с правого фланга!	F6

%Мина!	Ctrl+F1
%Шафт!	Ctrl+F2
%Нужна Изида!	Ctrl+F3
Не стрелять!	Ctrl+F4
Атака с левого фланга!	Ctrl+F5
Атака по центру!	Ctrl+F6
Атака с правого фланга!	Ctrl+F7
Атака сверху!	Ctrl+F8
Атака снизу!	Ctrl+F9

Так точно!	Shift+F1
Никак нет!	Shift+F2
Выполняю.	Shift+F3
Прошу прощения.	Shift+F4
Отличный выстрел!	Shift+F5
Слишком долго!	Shift+F6